................................................................................................
................................................................................................
................................................................................................
................................................................................................
................................................................................................
................................................................................................
................................................................................................
................................................................................................
................................................................................................
................................................................................................
................................................................................................
................................................................................................
................................................................................................
................................................................................................
................................................................................................
..P...............^......................^..................K...^............................G..
#########....###########....####....###########....####....###########....####....####....######
#########....###########....####....###########....####....###########....####....####....######
#########....###########....####....###########....####....###########....####....####....######
